111111111111111
100010000000101
1000000C0000001
100000000000001
1000000P0C00001
100000000000001
1000000E0000001
1000000000E0001
111111111111111
