111111111111111
11111C1E1P11111
111111111111111
