111111111111111
100000000000001
1000000C0000001
100000000000001
1000000P0000001
100000000000001
1000000E0000001
100000000000001
111111111111111
