111111111111111
1P0C10000C001C1
100110101010101
100000101010101
100010101010101
11101010C010001
1C1010111111011
1000100000000E1
111111111111111
