111111111111111
1000100000001G1
1000P0000C00001
100000000000001
100000000000001
10000000E000001
100000000000001
100000000000001
111111111111111
