111111111111111111111111111111111111111111111111111111111111
100010000000000000000000010001G000000000000000000000000001E1
1000P0000C0000000000000000000000000000000000000000000100G001
100000000000000000000000000000000000000000000000000001111111
100000000000000000000000000000000C00000000000000000000000001
100000000000000000000000000000000000000000000000000000000001
100000000000000111111010101000000000000000000000000000000001
10000000000000010C0C0000001000000000000000000000000000000001
100000000000000100C0C000001000000000000000000000000000000001
100000000000000000000000001000000000000000000000000000000001
1000000000000001111111111110000000000000000C0000000000000001
100000000000000000000000000000000000000000000000000000000001
100000000000000000000000000000000000000000000000000000000001
100000000000000000000000000000000000000000000000000000000001
100000000000000000000000000000000000000000000000000001111101
1000000000000000000000G00000000000000000000000000000000100E1
100000000000000000000000000000000000000000000000000000010001
1000000000000000000000000000000000000000000C000000000C000001
100000000000000000000000000000000000000000000000000000000001
10000000000000C000000000000000000000000000000000000000000001
100000000000000000000000000000000000000000000000000000000001
100000000000000000000000000000000000000011111111111000000001
10000000000000000000000000000000000000001000000000000C000001
100000000000000000000000000000000000000010000000000000000001
100000000000000000000000000000000000000010000000000000000001
10G00000000000000000000000000000000000001000000000000E000001
1000000000000000000000000000000000000000000000000000000000G1
111111111111111111111111111111111111111111111111111111111111
