111111111111111
100010000000101
1000P0000C00001
100000000000001
100000000000001
10000000E000001
100000000000001
1000E000000C001
111111111111111
